|     |     |
|           |
|     |     |
|     |     |
|     |     |
|     |     |
|     |     |
|     |     |
|     |     |
|     |     |
|     |     |
|     |     |
|     |     |
|     |     |
|     |     |
|     |     |
|     |     |
|     |     |
|     |     |
|     |     |
|     |     |
|     |     |
|     |     |
|     |     |
|     |     |
|     |     |
|     |     |
|     |     |
|     |     |
|     |     |
|     e     |
|     |     |
|     e     |
|     |     |
|     e     |
|     |     |
|     e     |
|     |     |
|     |     |
|     |     |
|     |     |
|     |     |
|     |     |
|     |     |
|        e  |
|     |     |
|     |  e  |
|     |     |
|     |     |
| e         |
|     |     |
| e   |     |
|     |     |
|     |     |
|     e     |
|     |     |
|     e     |
|     |     |
|           |
|   e | e   |
|     |     |
|   e | e   |
|     |     |
|     |     |
|     |     |
|     |     |
|     |     |
|     |     |
|     |     |
|     |     |
|     |     |
|     |     |
|     S     |
|     |     |
|     |     |
|     | S   |
|   S |     |
|     |     |
|     |   S |
|     |     |
| S   |     |
|     |     |
|     |     |
|     |     |
|     |     |
|     |     |
|     |     |
|     |     |
|     |     |
|     S     |
|    S|S    |
|     |     |
|     |     |
|     |     |
|     |     |
|     |     |
| E   |   E |
|     |     |
| E   |   E |
|     |     |
| E   |   E |
|     |     |
|     |     |
|     |     |
|   E | E   |
|     |     |
|   E | E   |
|     |     |
|     |     |
|     |     |
|     |     |
|     |     |
|     |     |
|   S | S   |
|     |     |
|     |     |
|     |     |
|  S  |  S  |
|     |     |
|     |     |
|     |     |
|     |     |
|     |     |
|     |     |
|     |     |
|     |     |
| R         |
|     |     |
|   R |     |
|     |     |
|     R     |
|     |     |
|     | R   |
|     |     |
|     |   R |
|     |     |
|     |     |
|     |     |
|     |     |
|     |     |
|           |
|     |     |
|     |     |
|    E|E    |
|     |     |
|  E  |  E  |
|     |     |
|E    |    E|
|     |     |
|     |     |
|     |     |
|     |     |
|     R     |
|     |     |
|     |     |
|     |     |
|     |     |
|     |     |
|     |     |
|     |     |
|     |     |
|     |     |
|     |     |
|  S  |     |
|     |     |
|     B     |
|     |     |
|     |  S  |
|     |     |
|     |     |
|           |
| S   |     |
|           |
|     |     |
|     |     |
|     |     |
|     |     |
|     |     |
|     |     |
|     |     |
|     |     |
|     |     |
|           |
| e   |   e |
|     |     |
| e   |   e |
|     |     |
| e   |   e |
|     e     |
| e   |   e |
|     |     |
|     |     |
|     |     |
|     |     |
|     |     |
|     |     |
|     |     |
|     |     |
|     |     |
|     |     |
|     |     |
|     |     |
|  S  |S  S |
|     |     |
|     |     |
|     |     |
|     |     |
|     |     |
| R   |   R |
|     |     |
|     |     |
|     |     |
|     |     |
|     |     |
| e e | e e |
|     |     |
|  e  |  e  |
|     |     |
|     |     |
|     |     |
|     |     |
|     |     |
|     |     |
|     |     |
|     |     |
|     |     |
|     |     |
|     |     |
|     |     |
|   R | R   |
| R   R   R |
|   E | E   |
|     |     |
|     |     |
|     |     |
|     |     |
| e   |   e |